[nivel1]

origen = fondo.png
mapa= #########################
      #...........#........#..#
      #...........#...........#
      #..#######..#..#..#.....#
      #........#.....#######..#
      #........#.....#........#
      #######..#######........#
      #........#........#######
      #........#........#.....#
      #..####..#........#.....#
      #..#........####..#..#..#
      #..#........#...###..#..#
      #..##########...###..#..#
      #........#...........#..#
      #........#...........#..#
      ####..#..#..##########..#
      #.....#.....#...........#
      #.....#.....#...........#      
      #########################


[.]
nombre=pasto
ux=11
uy=0
muro=0

[#]
nombre=pared
ux=0
uy=4
muro=1


